PathSpecimenType	Class
PathSite	Class
PathSide	Class
PathHistology	Class
ClinicalHistory	Class
PathSignedDate	Class
PathCollectedDate	Class
PathReceivedDate	Class
Pathologist	Class
OtherFinding	Class
PathQuality	Class
PathStageT	Class
PathStageN	Class
PathStageM	Class
PathStageSystem	Class
Behavior	Class
Her2FISH	MLClass
Her2IHC	MLClass
Nottingham	MLClass
Mitotic	MLClass